accreting->accrediting
addes->adds, added,
alocation->allocation
anarchistm->anarchism
androind->Android
anly->only
beind->behind
bufferes->buffers
bumber->bumper, bomber, bummer,
calle->called
callef->called
calles->calls
coersion->coercion
cognizent->cognizant
comman->command, common, comma,
composte->composite, compost, composted,
containes->contains
corse->course
cound->could, count,
covnertor->convertor
cunter->counter
cutted->cut
dasy->daisy
decelaration->declaration
devide->divide
devides->divides
doas->does
enity->entity
existend->existed
exort->export
expection->exception
expections->exceptions
expreses->express
extraversion->extroversion
extravert->extrovert
extraverts->extroverts
faile->failed
falsy->falsely, false,
fase->faze, phase,
focussed->focused
focusses->focuses
fromt->from
hald->held
hemmorhage->hemorrhage
hemorage->haemorrhage
hights->height
icognito->incognito
ideosyncracies->ideosyncrasies
ifset->if set
incogito->incognito
incognitio->incognito
inflight->in-flight
instutions->intuitions
interated->iterated, interacted,
interates->iterates, interacts,
interating->iterating, interacting,
interation->iteration, interaction,
Januray->January
JavaSciript->JavaScript
keypair->key pair
keypairs->key pairs
keyservers->key servers
keywork->keyword
labbeled->labeled
labed->labeled
lesstiff->lesstif
loosy->lossy, lousy,
measuer->measurer
memembers->members
merly->merely
modle->model
mose->more, mouse,
MSDOS->MS-DOS
nast->nest, mast,
necessarly->necessarily
neeed->need
ninjs->ninja
noe->not, no, node, know, now,
nore->nor, note, more,
ond->one
ony->only, on,
parameterizes->parametrizes
paramterization->parametrization, parameterization,
Pharoah->Pharaoh
pich->pitch
poer->power
posion->poison, Psion,
posioning->poisoning
pount->point
prefence->preference
pris->prise
pullrequenst->pull requests, pull request,
pullrequest->pull request
pullrequests->pull requests
quating->quoting, squatting,
reacher->richer
readed->read, readd, readded,
reall->real, really,
refocussed->refocused
relected->reelected
resizeable->resizable
resizeble->resizable
respone->response
ro->to, row, rob, rod, roe, rot,
sharable->shareable
shatow->chÃ¢teau
spawnve->spawn
standars->standards
stati->statuses
stript->stripped
succees->success
tast->taste
tooo->todo
ture->true
tyhe->they, the,
unaccesible->unaccessible
unintented->unintended
unsed->unused, used,
unsharable->unshareable
unsing->using
upto->up to
visted->visited
visting->visiting
warmup->warm up, warm-up,
whill->will
